==================== Display keys in ascending order by hash values ====================
Nick Green | Justin Fargas | Ben Broussard | Olindo Mare | Wade Smith
Terreal Bierria
Donald Willis
Tony Cogan | Terrence McGee | John Jaha
Angel Echevarria | Adam Haayer | Luis Castillo
Josh Johnson | Tony Dixon
Kyle Richardson
Matt Thornton | Billy Wingfield
Dez White | James Farrior
Kenny Mitchell | Mark Bellhorn
C.J. Nitkowski | Matt Watson
Dwight Freeney
Robby Hammock | Mike Minter | Sam Marsonek
Tony Case | Dylan McFarland | Daylon McCutcheon
Todd Self
Orlando Pace | Newel Matavao | Jeff Tam | Karl Williams
Randy Jordan
Scott Cunningham | Greg Ellis | Jason Shiell | Jeff Nelson
Donte' Stallworth | Delino DeShields
Renauld Williams
Patrick Venzke
Jose Valverde
Jacques Reeves | Pat Thomas
J.R. House | Chris Shreve | Pat Borders
Curtis DeLoatch
Ken Lucas
Mickey Callaway
Ryan Denney
Julian Tavarez
William Hampton | Roy Manning | Ifeanyi Ohalete | Felix Rodriguez | Jerry Hairston Jr.
Obiajulu Arah | Aaron Schobel | Chris Haney | J.J. Hardy | Felix Diaz
Kelvin Garmon
Chris Akins
Stephen Alexander | Mike Lamb
Ed Perry | Darrell McClover | Al Leiter
Randy Messenger
Kendrick Clancy | Chris Stynes
Steve Cox | Keith Reed | Todd Greene | Ryan Hannam | Jim Finn
Willie Anderson | Ichiro Suzuki | Chris Oxspring | Mariano Rivera | Geoff Geary
Justin Lucas | Jay Gibbons
Ben Utecht | Tony Graffanino
Fernando Bryant | Rey Ordonez | Bobby Witt
Robert Quiroga
Gilbert Gardner | Oswaldo Mairena
Sean Berton | Tony Grant
Andre Lott | Casey Hampton | Sammy Sosa | Drew Hodgdon | Brandon Calton
Damian Miller
Greg Favors | Kalvin Pearson | Jay Foreman
Joe Borchard | Ellis Wyms | Plaxico Burress | Chris Latham
Angel Berroa | Bobby Sippio
Drew O'Connor | Ryan McGuffey | Mike Venafro | Dwayne Carswell
Harold Baines | T.J. Cottrell | Chad Durbin | Eddie Taubensee | Brock Gutierrez
Emmitt Smith | Chad Mottola | Josh Bard | Willie Parker | Lance Briggs
Jon McGraw | Alex Rios
Chuck Wiley
Jose Lopez | Gavin Hoffman
Randy Johnson | Jesus Colome
BSCS | Tad Golden
Kabeer Gbaja-Biamila | Rick Mirer
Dewayne Washington | Bobby Chouinard
John Bronson
James Allen | Jose Guillen
Scott Randall | Greg Lewis | Jason Schmidt
Keith Smith | Jeremy Akers
Todd McMillon | Corey Parchman
Eude Brito
Fall | Jeff Mathis
Shin-Soo Choo | Alex Hernandez
Casey FitzSimmons | Adimchinobe Echemandu
Louis Green
Robert Porcher | Jose Capellan | Tyrone Jones
Ben Watson | Joe Wong
Dave Berg | Curtis Pride | Kevin Mawae | Ki-Jana Carter | Marc Colombo
J.T. O'Sullivan | Adam Bernero
Andy Van Hekken | Randee Drew | Aaron Rodgers
Troy Mattes | Armando Rios | Nick Harper | Terry Cousin | Lance Mitchell | Scott Atchison
Derek Smith | Michael Tejera
Jackie Mitchell | Mike Pearson | Alex Herrera
Jeff Keppinger | Chris Nichting | Ross Gload
Carlos Mendez
Jessie Armstead
Denny Neagle | Matt Zielinski
Reggie Sanders
Cosey Coleman | Tony Womack
Shawn Barber
Andre Carter
Tony Banks
Derrick Mason | Joe Judge | Alex Bannister
Dwan Edwards | Nat Dorsey
DeLawrence Grant | Francisco Cordero | Raul Ibanez
Jason Botts | Todd Franz | Brandon Larson | Alge Crumpler | Dave Yovanovits
Jeff Tabaka
Bennie Anderson | Pete Harnisch
Jose Silva | Brandon Backe | Clinton Hart
Lynn Scott | Wayne Lucier
Kalimba Edwards | Luis Ordaz
Jay Kulaga | Travelle Wharton | Trev Faulk
Justin Snow | Marcellus Wiley | Brandon League | Fred McGriff
Micah Ross | Greg Colbrunn | Tim Stauffer
Xavier Nady | Nerio Rodriguez
Chad Allen
Nick Hardwick | Jarrod Washburn
Itula Mili | Ron Warner
Alex Arias | Dioner Navarro | Jared Clauss
Alfonso Boone | Tony Gilbert
Jeff Suppan | Isaiah Kacyvenski
Alex Ochoa | Elton Brown | Danny Bautista | Todd Steussie
Charon Arnold | Talman Gardner
Bryce Florie
Jabari Greer | Ricky Bottalico | Billy Bajema | Kevin Breedlove
Bethel Johnson | Raonall Smith | Nick Goings | Ryan Minor | Quentin Griffin
John Riedling | Roderick Babers | Stephen Davis
Mark Buehrle | Akin Ayodele
Jermane Mayberry | Reggie Kelly | John Gall | Jake Robbins
Chris Duncan
Mike Adams | Desi Relaford
Ebenezer Ekuban | Travis Stephens | Kenny Zordani | Chad Lucas
Keith Williams | Kevin Mathis | Sandy Alomar Jr. | Brian Boehringer
Hanik Milligan
Lance Davis
Tyson Walter
Chris Downs | Carlos Pena | Johnny Estrada | Donovin Darius
Matt Light
William Henderson
Tony Fisher
Chris Carr
Chris Woodward | Brandon Mitchell
Gary Majewski
Kendyl Jacox | Oliver Celestin | Joey Thomas
Skip Schumaker | Gene Mruczkowski | Jon Bradley | Brock Huard
Steve Bechler | Brandon Knight
Nathan Chandler | Juan Castro | Jarrod Cooper | Moran Norris | Clay Hensley | Joe Kennedy
Maicer Izturis | Jeff Wallace | Rob Vian
Desmond Clark | Tai Streets
Cristian Guzman
James Davis
Robert Andino | Adam Dunn | Lito Sheppard | Trent Durrington | Rick White
Mike Logan | Tim Crabtree
Brett Favre | Rod Smith | Rex Grossman | Brad Kassell
Travis Johnson
Leo Nunez | Jordan Carstens
Maake Kemoeatu
Jimmy Anderson | Brad St. Louis
Chip Ambres
Jeff Fassero | Hannibal Navies
Russ Davis | Shawn Terry | Pedro Feliciano | Mickey Lopez
Lorenzo Neal | Travis Miller
Josh Thomas | Nate Washington
Donne Wall | Jayson Werth | Aaron Sele | Jim Brower | Kailan Williams | Mark Redman | Eric DuBose
David Barrett | Steve Avery | David Newhan | Felipe Lopez | Derrick Strait
Maurice Williams | Jamie Henderson | Rod Smart | Kirk Bullinger
Warrick Holdman | Ryan Longwell
Jose Antonio Nunez | Lamain Rucker | Pedro Martinez
Cory Schlesinger | Junior Spivey | Jovan Haye | Scott Harper
Jim Edmonds | Rusty Greer
Jose Contreras | Kenyatta Wright | Chris Chandler
Adam Treu | Ryan Glynn | Travis Kirschke | Keary Colbert
Billy Silva | Chris Cash
Curtis Granderson | Chris Gardocki | Terrence Holt | Marty Cordova
Matt Hasselbeck
David Weathers
Eric Downing | Fernando Vina | Cornell Brown | Jarrod Patterson
Jhonny Peralta | Damion Easley
John Foster | Don Davis
Chukky Okobi | Jimmy Rollins | Eric Hinske
Stephen Neal | Edwin Encarnacion | Heath Evans
John Miller | Antoine Cash | Charlie Batch
Ryan Klesko | Michael Clayton | Duane Starks | Brandon Winey
Brian Jones
Jamal Robertson | Clay Roberson
Jose Nieves
Jason Varitek | Darin Erstad | Paul Smith | Fred Robbins
Marco Scutaro
Ben Sheets | Sean Mahan | Jason Thomas
Adam Timmerman | Sterling Hitchcock | Yadier Molina
Kiwaukee Thomas | T.J. Mathews
Placido Polanco
Chris Saenz
Chien-Ming Wang | Esix Snead
Marquis Grissom
Cecil Sapp | Adam Hyzdu
Rondell White | Chris Naeole
Bernard Berrian
Mike Compton | Rocky Biddle
Shurron Pierson
Anthony Simmons
Benito Baez
Mark Moroz
Zack Greinke | Joe Schey | Kevin Hardy | Orlando Palmeiro
Franklyn Gracesqui | Damien Woody | Jonny Gomes
Jeremiah Trotter | Jeff Smoker
Casey Fitzsimmons | Ken Hamlin
Jeff Ulbrich | Brandon Gorin
Dave Veres | Doug Johnson | Jerheme Urban | Shaun Ellis
Leigh Torrence | Erick Almonte | Chauncey Davis | David Justice
John Howell | Enrique Cruz | Dustin Barno
LaTroy Hawkins
Luis Rodriguez | Nate Teut | Jeff Garcia | Keith Stokes
B.J. Ward | Tommy Phelps
Mark Roman | Paul Byrd | Michael Hart | Timo Perez
Brian Rimpf
LaBrandon Toefield
Barry Zito
Jason Kyle
Gabe Gross
Damien Richardson | Jason Craft
Phillip Doolin
Todd Erdos
Matt Perisho | Dante Powell | Mark Watson
Blake Stein | Matt Lawton | Scott Service
William Whitticker | Clinton Portis | Gary Glover | Donald Malloy | Ron Flores
Larry Sutton
Justin Gage
Tony Tarasco | Lofa Tatupu | Jason Christiansen
Tom Lampkin | Richard Lewis | Colin Porter | Wil Nieves
Ronald Bartell | Greg Dobbs
Mark Quinn
Keith Cottrell
Mark Hendrickson | Travis Chapman
Ryan Riddle | Kelly Butler | Jason Vargas
Johan Santana | Emil Brown | Ibrahim Khan | Casey Fossum | Scott Sauerbeck
J.J. Davis | Dan Wilkinson | Kimera Bartee | Chris Henry
Mike Crudale
Luis Matos
John Paul Foschi | Cla Meredith
Denny Bautista | Will Hunter | Jose Jimenez | Derrius Thompson
T.J. Hollowell
Deneil Anglin | Justin Verlander
Michael Strahan | Kabeer [1457]Green Bay Packers Gbaja-Biamila
Dougie Allen | Domanick Davis | Bryan Hickman
Eric Cyr | Toby Borland | Sean Jones
Ken Hill | Rocco Baldelli
Calvin Pace | Jerricho Cotchery | Lamont Hall
Dedric Ward | Ariel Prieto | Kenny Lofton
Brian Scott | Brad Hoover | Ramon Nivar | Mark McGwire
Aquilino Lopez | Ezequiel Astacio | Nate Wayne | Stockar McDougle
Terrell Willis | Jim Parque | LeRon McCoy | Jeff Robinson
Julio Mateo | Conor Jackson
Pat Pidgeon | Paul Mandina | Trenidad Hubbard | Dave Hollins
Lamont Thompson | Kerry Linnear
Michael Turner | Russ Springer
David Boston
Alex Jackson
Devard Darling | Darian Barnes | Juan Gonzalez | Bo Lacy
Chris Shelton
Jason Stanford | Chris Ray | Derrick Gibson | Joel Hofmann
Sean Taylor | Doug Clark | Julio Franco
Andrew Good | Chris Hovan
Terrell Buckley | Edwin Almonte | David Brandt
Jason Webster
Nick Punto
Willie Roaf | Gustavo Chacin | Shane Lechler
Brian Urlacher | Zak Kustok | Grant Williams | Jerry Rice | Carlos Lee
Marques Brigham | Brian Goolsby
Dennis Tankersley | Francisco Rodriguez | Kit Pellow | Rabih Abdullah
Eric Steinbach | Zach Thomas | Joseph Jefferson
Eric Moulds | Antwan Odom | Brennan Ochs
Jose Hernandez
Brad Radke
Randal Williams | Jon Jansen
Kenny Watson | Cie Grant
Isaiah Ross
Shawn Sedlacek | Aaron Cook
Belton Johnson
Josh Pearce | Lousaka Polite
Joey Goodspeed | Grady Jackson | Tony Giarratano
Keenan Howry | Rocky Bernard
Chad Lavalais | Eric Valent | Kevin Hooper | Herbert Perry
Chris Booker | Artrell Hawkins
Joe Hietpas | Edgar Renteria
Larry Walker | Guillermo Mota | Brian Giles | Jack Cressend
Kendall Gammon
Scott Starks | Zack Bronson | Jeff Kent | Jason Lane
Tab Perry | Todd Jones
Nick Speegle | Tino Martinez | Jamey Wright
Shawn Hay | Johnnie Morton
Garnell Wilds
Jeff Frye
Mark Johnson | Eric Hicks
Tyler Watts
Kurt Warner | John Welsh | Tank Williams | Randy Moss | Bobby Smith
Ronnie Brown
Derrick Dockery
Oscar Salazar | Mike Bordick
Bobby Kielty | Spencer Johnson | Major Applewhite | Grant Irons | Paul Quantrill | Robert Taylor | Jason McKie | Jeremi Gonzalez
Chris Reitsma
Damione Lewis
Alex Cora | Javier Cardona
Jeremy Conley
Casey Wiegmann | Chris Capuano | Todd Collins
Kevin Gregg | Mike Maroth | Chad Johnson
Keylon Kincade
Pedro Liriano | Scott Cassidy | Carl Crawford | Chris Luzar
Kevin Mench | Matt Mantei | Kendall Simmons
Hector Ortiz | Jimmy Osting | Mike Benjamin | Dan Campbell
Ben Ford
Edwards Guzman
Shane Olivea | Larry Moore | Lance Berkman
Anderson Hernandez | J.D. Smart
Craig Dingman | Cal Eldred | Shad Meier
Pat Dennis | Sebastian Janikowski
Bud Smith | Mike Sweeney | Kevin Curtis
Jason Simontacchi | Gerald Laird
Sheldon Brown | Anthony Telford
Chris Canty
Josh Lyman
Kevin Brown | Khalif Barnes
Chris Fuamatu-Ma'afala
Kelvin Pritchett
Joey Galloway
Fred Pagac
Willie Pile | Jose Fernandez
Chris Nofoaiga
Tim Johnson | Bill Whittemore | Jeremy Hermida
Matt Simonton | Bhawoh Jue | Larry Izzo
J.J. Trujillo | Rich Garces | Pig Prather
Steve Schmoll | Mike Rose
James Lofton | Alan Embree | Lenny Harris | B.J. Askew | Denny Stark
Chris Aguila | Osvaldo Fernandez
Chris Bober | Roy Williams | Dave Ragone
Noel Prefontaine | Kyle Larson
Cameron Worrell | Mark Petkovsek
Sean DePaula | Shane Riggs | Terrance Copper | Michael Coleman
Brett Williams
Roscoe Parrish | Eddie Drummond | Sean Casey | Andrew Lorraine | A.J. Hinch
Israel Idonije | Endy Chavez | Ricky Bones
Lui Fuata
John Burkett | Keyuo Craver | Chad Sears | Chris George
Derreck Robinson | Adewale Ogunleye
Willie Ponder | Brian Kuklick | Ruben Rivera | Ike Taylor
Verron Haynes
Jake Peavy | Mike Magnante
Aubrey Huff | Robert Reed | Donald Strickland
Bobby Bonilla | James Darling | Brent Butler
Pedro Lopez | Troy Brown
Chad Orvella | Adrian Hernandez
Scott Sullivan | Manny Ramirez
Roy Oswalt
Melvin Fowler | Michel Hernandez
Joe Dillon | Frank Livingston | Bubba Franks
Mike Mohler | Aaron Rakers | Reggie Hayward
Reno Mahe | Wes Welker | Montae Reagor | Kemp Rasmussen | Jack Hawley
Marc Valdes | Chris McAlister
Matt Ford
Oscar Robles | Larry Stevens
Bobby Hill | Jason Grilli | Mark Corey | Humberto Quintero
Val Pascucci
Kendyll Pope | Tyrone Poole | Michael Boley
Na'il Diggs | Ryan Dempster
David Thompson
Alain Kashama | Peter Bergeron | Joe Valentine
Marc Edwards | Aveion Cason | Cory Bird
Brandon Moore | Shawn Wooden
Warrick Dunn | Paul Grasmanis
Jonathan Wells | Lennie Friedman
Doug Pederson
Brandon Stephens
Ronnie Heard | Brian Rose | Carnell Williams | Josh Labandeira | Jermaine Haley | Corey McIntyre
Cory Hannen
Kyle Denney | Kenyon Coleman
Kirk Chambers | Damon Huard | Al Johnson
Ryan Jensen
Ted Johnson | Erasmo Ramirez
Yuniesky Betancourt | Junior Ioane
Andre Offing | Phillip Daniels
Bobby Seay | Tim Hudson | Donnie Abraham
Derrick Rodgers | Hector Luna
Shawon Dunston
DeAngelo Hall | Patrick Estes | Jorge Piedra
David Cortes
Shane Loux | Mike Leach | Steve Kline | Norm Charlton
Brad Meester | Derick Armstrong | Nick Newton | Coy Wire | Troy Vincent
Ryan Drese | Jason Garrett | Chris Wakeland
Jason Romano | D.D. Lewis
Matt Turk | James Butler | Rod Barajas
Todd Williams | Ryan Doumit
Dominic Rhodes
Chad Killian
Bruce Perry | Kory DeHaan
Mike Johnston | Jonathan Pritchett
Kevin Shaffer
Josh Foster | Charlie Garner | Vladimir Guerrero | Darrent Williams
Antwan Peek
Jacque Jones | Eddy Garabito
Nick Regilio | Josh Miller
Nook Logan | Preston Hartfield | Charles Nagy
Robert Mackey | Mark Mulder | L.J. Smith | Chaun Thompson
Alan Benes | Antwan Lake
Norman Hand | Jashon Sykes
Jeff Francis | Scot Shields | Marquis Cooper
Jose Vidro | Jake Scott | Nick Narcisse | Andy Dominique
Danny Sandoval
David Akers
Josh Davis | Michael Stone | Jason Conti
Ryan Diem | Mike Bynum
Matt Herges
Isaiah Harris
Ethan Albright | Tadahito Iguchi
Paul Spicer | Tony Hollings | Mike James | Chartric Darby | Marquis Horn
Scott Chiasson | Ken Vining | Damon Hollins
Mike Burns | Troy Hambrick | Greg Warren | Mike Flanagan
Dae-Sung Koo | Scott Fujita
Joe Odom | Dave Ball | Eddie Eviston | Kenoy Kennedy
Bob File | Bubba Trammell | J.J. Furmaniak
Luis Sojo | Scott Mruczkowski | Blake Elliott | Jorge Velandia | Drew Carter
Jeremy Loyd | Jeremy Shockey
Bob Howry | Craig Paquette
Cesar Crespo | Mike Echols | Martin Gramatica | Keyonta Marshall
Kent Bottenfield
Drew Henson | Chris Cooper | Terry Jones
Woody Williams
Jonathan Babineaux | Joe Horn | Nicolas Luchey | Matt Willig | Ryan Shealy
Craig Terrill | Tiki Barber | N.D. Kalu | Reggie Taylor
Darnell Dockett
David Cone | Mike Cloud | Gookie Dawkins
Robert Geathers | Ron Coomer | John Barnes | Tommie Harris
Travares Tillman | Alex S. Gonzalez | Vonta Leach
Rian Wallace | Geoff Blum | Tony Williams | Joaquin Benoit
Cory Lidle | Dan Kreider | Charles Johnson
Casey Bramlet | Eli Manning
Jeb Terry
Kevin Tolar | Justin Huisman
Aaron Moorehead | Justin Lehr
Ben Coleman | John Wade
D.J. Williams | Adam Everett
Craig Krenzel | Dane Sardinha | Leigh Bodden | John Owens
Ryan Krause | Tony Eusebio | Matt McCoy | Matt Schaub
Matt Morris | Laveranues Coles | Frank Rodriguez | John Matich
Mike Matthews | Gregg Zaun | Aaron Martin | Mark Fields
Greg Walker | Matt Stover
Shaun Smith
Jeremy Affeldt | Jason Karnuth
Jamar Fletcher | Eric Karros | Omar Quintanilla
Chad Slaughter
Kevin L. Brown
Steve Edwards | Kenton Keith | Alfred Fincher | Kurt Ainsworth | Osi Umenyiora
Scott Servais | Scott Sobkowiak
Adam Riggs
Brian Shouse | Torrance Marshall | Chris Hetherington | Kynan Forney | Omar Infante
Cols Colas
Dustan Mohr | Gregg Guenther | Peter Warrick | Corky Miller
Rusty Meacham | Adam Piatt | Garrick Jones | Ronald Curry
Pete Walker | Brian Russell
Anastacio Martinez
Walter Jones
Brandon Johnson | Adrian Awasom | Heath Miller
Kyle Orton | Mark Grace | Tim Corcoran
Ryan Clark
Matt Giordano
Ben Miller | Adam Kennedy | Chad Clifton
Keith Adams
Kyle Kosier | Mark Malaska
Brad Voyles | Rick Helling
Alex Pelaez | Jeff Baker
Erik Bickerstaff | Darren Bragg
Lonie Paxton | Dewon Brazelton
Makoa Freitas | Vernon Wells | R.W. McQuarters | Joe Siofele
Michael Tucker | Josh Reed
Chris Bootcheck | Kenny Smith
Barry Larkin | Ashley Ambrose | Darwin Walker
Dexter McCleon | Paul Edinger | Jimmy Fitts
Mike Morgan | Marques Anderson
Carson Palmer | Tanyon Sturtze | Charlie Landrigan | Colin Cole
Greg Wesley
Kevin Sampson | Justin Duchscherer | Bartolo Colon
Jason Isringhausen | Rodney Leisle
Dan Wright | Brad Hawpe | Peyton Manning
Louis Ayeni
Jarad Moon | Sean Lowe | Brady Anderson
Kurt Sigler | David Aardsma | Mike Coolbaugh
Mike DeJean
Trent Dilfer | Ronny Cedeno
Kwame Harris | Troy Glaus
Dan Meyer | Shayne Graham | Artis Hicks
Randy Keisler | Wendell Bryant | John Lackey
Shaun Rogers | Reggie Swinton | Ron Atkins
Daryle Ward | Kris Stockton
Steve Reed | Philip Rivers | Brian Buchanan
Clint Nageotte | Rob Bell | Doug Brien | Sean Locklear | Tarik Glenn
Lance Cormier | Blaine Saipaia
Hollis Thomas | Orlando Cabrera
David Dellucci | Doug Waechter | Ismael Valdez
Keion Carpenter | Pete Schourek | P.J. Alexander | David Carr
Chukie Nwokorie | D.T. Cromer
Matt Kinney | Ryan Neufeld
Carlos Hernandez | Joe Maese
Tim Hummel
Carl Ford | Kevin Kaesviharn
Lamar Gordon | Curtis Deloatch | Jake Woods
Jay Ratliff | Jerome Carter | Brandon Stokley
Matt Schobel | Ian Gold | Mike Nugent
Todd Wellemeyer
Alex Smith | Quilvio Veras | Paris Lenon | Dave Mlicki
Dexter Coakley
Chris Chambers | Chad Cordero | Troy Evans | Albert Haynesworth
Danny Klassen | Ricky Gutierrez
Mike Cameron | Robert Grant
John Parrella | Walt Harris
Cedrick Wilson | Rob Ducey | Troy Percival
Larry Smith | Serge Sejour | James Newson
Jeremiah Cockheran | Dan Smith
Aaron Brooks | Shaun Hill | Tim Brown | Omar Olivares | Brian Westbrook
Nick Luchey | Jason Grimsley
Byron Leftwich
Steve Smith | Jeff D'Amico | Marcus Thames
Mike Pucillo | Jim Thome | Erik Coleman | Spencer Folau
Takahito Nomura | Gerald Sensabaugh
Kareem McKenzie
David Givens | Deshea Townsend
LeCharles Bentley | Anthony Hargrove
Wesly Mallard | Edward Reese | Chester Taylor
Brandon McCarthy | Jacob Rogers | Kevin Faulk
Trent Smith | Edison Volquez
Teddy Sims | Jim Mecir | Kerry Robinson
Derrick Turnbow | Blaine Neal
Robert Tate | Everett Stull | Todd Wade
Omar Easy | Nate Poole | Jake Westbrook | Eddie Jackson | Chris Piersoll
Andy Sheets | Izzy Alcantara
Neil Johnson | Josh Parry
James Reed
Jason Alfaro
Je'Rod Cherry | Justin Kaye
Orlando Ruff | Travaris Robinson
Andy Marte | Jon Garland
Gregg Olson | Reggie Williams
Jon Rauch | Andy Green | Anthony Bryant
Ephraim Salaam | Al Harris
Adrian Wilson | Travis Cole
Seth McClung
Damien Robinson | Jason Short | Fred McAfee | Stubby Clapp | Wil Cordero
Colter Bean | Brendan Donnelly
Brad Penny | Mike Guazzo | Cody Ross | Josias Manzanillo
Benito Santiago | Nakoa McElrath
Spring 
Alberto Castillo
Scott Eyre | Russ Adams | Mike Brown | Tim Raines Jr. | Ricardo Colclough
Willis Roberts | Kordell Stewart | Jim Maxwell | Willis McGahee | Drayton Florence
Jeremy Newberry
Andre' Goodman | Darren Lewis | Ray Buchanan
Travis Harper
Larry Tripplett | Vance Wilson
John Lynch | Victor Zambrano
Madieu Williams
Terrell Owens | Randy Velarde | Ryan Myers
Gino Capone | Jason Bell
Craig Biggio | Cory Redding
Jorge DePaula | Stephen Cooper
Justin Germano | Rob Bowen | Matt Leonard | Damion Cook
Anton Palepoi
Edgerrin James | Doug Gabriel
Dusty Bergman | Artose Pinner
Chad Paronto | Carlos Almanzar
Drew Wahlroos | Francisco Cruceta | Erik Hiljus
Pasqual Coco | Aaron Guiel | A.J. Pierzynski | John Ennis
Justin Griffith
Juan Uribe | Clyde Simmons | Rob Milanese | Michael Wuertz
Nick Franklin
Hakim Akbar | Marcel Shipp
Anthony Sanders | Lou Merloni
Benny Sapp | Mike Esposito
Brad Scioli
Chris Brown | Huston Street
Eli Whiteside | Craig Counsell
Carlos Beltran | Matt Birk | Matt Belisle | Yaacov Yisrael
Henry Mateo | Michael Lewis | Jarrett Payton
Bobby Madritsch | Terrence Murphy
Brad Maynard
Shaun Alexander
Joselio Hanson | Rafael Palmeiro | Jarrod Baxter
Brad Johnson
Albert Pujols | Chris Snelling | Mark Teixeira | Will Smith
Ugueth Urbina
Bobby Estalella
Dave Meyer
Andre Johnson | Antonio Bryant
Ray Lankford | Morgan Kane
Shane Victorino
Jermaine Van Buren | Keith Wright | Marcus Washington | Damion McIntosh
Demetrin Veal | Stanley Pritchett
Jose Rijo | Ralph Turner
Jesse Palmer | Chris Snee | Nick Kaczur | Solomon Bates
Matt Cain | Marty Booker | Doug Davis
Fred Beasley | Jason Brown | Johnny Ruffin
Corey Jackson | Duaner Sanchez | Keyon Whiteside
Andrew Williams | Mike Vento
Ronnie Cruz | Derek Abney
Tim Olson
Robert Mathis | Brett Sterba
Maurice Morris | Marques Harris | Eric Wilson | Kane Davis
B.J. Ryan
Stephen Campbell
Ryan Zimmerman
Rich Aurilia | Jon Switzer
Mike Jacobs
Julio Mosquera
Muhsin Muhammad
Marcus Trufant | Josh Towers | Cletidus Hunt
Terrell Browden
Rashad Washington
Jerry DeLoach | Mike Hampton
Pablo Ozuna | Gerard Warren | Gary Brackett | Travis Bowyer | Lee Evans
J.P. Darche
Peppi Zellner | Trey Hodges
Jamie Martin | Chad Qualls | Jermaine Wiggins
Mike Tonis | Matt Cassel
Kazuhito Tadano | Matt Childers | Todd McClure | Amani Toomer
Ramon Castro | Lamont Reid
Jamal Lewis
Jose Leon | Rolando Arrojo | Ellis Burks
Jason McAddley | Maurice Hicks | Curry Burns
Lance Johnstone
Matt Katula
Jordan Gross | Jorge Toca | Jonathan Smith
Troy Edwards | Colby Lewis | Kenny Williamson | Dan Ortmeier
Ovie Mughelli | Sandy Martinez | James Baldwin
Cory Raymer | Ramon Vazquez | Michael Ryan
Donzell McDonald | Jerry Wilson
Josh Rupe | Montrae Holland
Jody Littleton | Nic Clemons
Max Starks | Sage Rosenfels | Carlos Silva | Cory Bailey
Lemar Marshall | Nick Collins | Dan Reichert | Barry Stokes | Ronde Barber
Brandon Whiting | Courtney VanBuren
Kahlil Carter | Matt Capps
Abraham O. Nunez | Jared McGrath
James Mungro
Wilson Betemit | Antonio Garay | Matt Hensley
Dave Magadan | Andre Dyson
Domonique Foxworth | Jamel White | Matt Clement | Jay Feely | Frank Castillo
Brian Roberts | Erubiel Durazo | Erik Flowers
Bill Haselman | Dexter Wynn | Kurt Kittner
Shawn Andrews
Chad Harville | Bengie Molina
Tim Harikkala | Jason Dunn | Paul Rigdon | Darnell Dinkins | Chad Pierson
Logan Kensing | Michael Jenkins | Dwaine Carpenter
Joe Jurevicius | Grant Wiley | Luis Lopez | Chad Hermansen
Steve Sparks
Bobby Abreu
Antwan Harris | Kazuhiro Sasaki | David Phillips | Wayne Hunter
Nate Bland | Andy Lee | Brian Schmack | Jerome Pathon
Ken Harvey | Casey Blake | Adam Archuleta | Joe Slusarski
Cedric Benson | Turner Ward | Scott Schoeneweis | Brad Bedell
Walter Young | Scott Downs | Eddie Johnson
Jason Kendall | Ola Kimrin
Chris Michalak | Daryl Dixon | Hector Almonte | Cleo Lemon
Chris Truby
Steve McKinney | Joe Salave'a | Brad Ausmus
Jim Molinaro | Victor Riley | Shantee Orr | Chris Kelsay
Michael Barrett | Pat Meares
Joe Roa | Joe Dawley | Phil Dawson
Mike Alstott | Dante Wesley
Roberto Petagine
Jason Frasor | Cleveland Pinkney
Alonzo Jackson | Ainsley Battles | Mike Holtz | Brandon Puffer
Vladimir Nunez | Juan Padilla | Glen Barker
Kevin Garrett | Scott Spiezio | Jarvis Green
Jeremy Thornburg
Kevin Houser
Vinny Testaverde | Jesse Orosco | Ryan Wagner | Daunte Culpepper
Mike Lieberthal | Brady Poppinga
Ramon Hernandez | Todd Devoe | T.J. Houshmandzadeh
Yorkis Perez | Sam Cowart
Dennis Norman | Cal Ripken Jr. | Kyle Peterson
Nick Ayers | Bryan Hebson
Jeff Brantley | Marviel Underwood
Kurt Abbott
Cliff Lee | Robert Holcombe | John Kasay | Shawntae Spencer
Shaun Phillips | Eddie Howard | Luis Gonzalez
Rick Reed | Vonnie Holliday | Wilson Delgado | Hideki Irabu | Todd Helton
J.D. Drew | Chris Widger | Calvin Maduro | Samie Parker
Matt Holliday | Aaron Walker | Nate McLouth
Richard Seigler
Tim Euhus | Brian Moehler | Mitch Meluskey
Scott Feldman | Rafael Soriano
Clint Barmes
John Vander Wal | Mark Jones | Jacob Cruz | David Riske | Eric Hall
Dave Roberts | Phil Seibel
Justin Bannan | Tim Hamulack
Onterrio Smith
Simon Fraser
Jamey Carroll
Eric Byrnes | Donald Lee
Charlie Hayes | Marcus Jensen
Billy Baber | Mike Neu | Darren Dreifort | Brian Cooper
Al Martin
Luis Vizcaino
Magglio Ordonez | Frank Menechino | Matt L. Miller
Lance Niekro | John Tait
Greg Brooks | Rodrigo Rosario
Tom Rouen | Pedro Borbon
Sean Douglass
Jeremy Giambi | Paul Wilson
Superior University | Jairo Garcia
Shawn Springs | Dennis Thomas | Cullen Loeffler | Todd Pratt
Marcus Giles | Kirk Rueter | Aaron Heilman | Scott Shanle | Rich Harden
Mike Gosling
Roc Alexander
J.P. Howell | Travis Lee | Corey Koskie
Francisco Liriano
Juran Bolden | Quentin Harris | Brett Romberg
Larry Chester | Reggie Rhodes
Buren Van | Corey Webster
Willie McGinest
Chris Thompson | Rodrigo Lopez
Ryan Jackson | Jermaine Clark
Bobby M. Jones | Runelvys Hernandez
Phil Nevin | LaDairis Jackson
N. Kalu | Grant Balfour | Eric Brown | Michael Green
Trey Lunsford | Aaron Myette | Randy Hymes
Jay Canizaro | Junior Seau
Scott Olsen | Walt McKeel | Will Ohman
Evan Mathis
Vernon Carey
James Thrash | Jose Mercedes | Dave Lee
Sam Williams
Brad Thomas | Michael Grant
Jose Lima | Colin Branch
Kevin Gryboski | Jason LaRue | Jimmy Wilkerson
Joey Devine
Joe McEwing
Gary Stills | Mesene Louisdor | JD Closser
Austin King | Aaron Harang | Richard Owens
Najeh Davenport | Trever Miller
Kyle Johnson | Trey Merkins
Rod Gardner | Dwain Goynes | Mark Prior
D.J. Hackett
Denard Walker | Earnest Graham
Josh Paul
Chris Singleton | Derek Thompson | Doug Linton | Alex Escobar | Jose Mesa
P.J. Forbes | Jason Kershner | Mark Nohra | Jason Boyd
David DeJesus
Paul McAnulty
Irfanuddin | Tony Badger | Gerald Hayes | Tsuyoshi Shinjo
Lahore Pakistan  | Lewis Sanders | Steve Finley | Dave Hansen
J.C. Romero
John Halama
Chris Hope | Amaury Telemaco | Darius Holland | Pokey Reese
Matt Ware | Luis Alicea
Tim Raines | Julius Jones | Bob Whitfield
Ruben Quevedo | Bill Swancutt | Phil Norton
Rick DeHart | Victor Rogers | Alex Graman
Brian Waters
Dunta Robinson | Shawn Green | Jeff Faine | Eric Warfield
Laynce Nix | Ryan Franklin
Tyrone Wheatley | Terrell Suggs | Koyie Hill | Lenny DiNardo
Lahore Pakistan | Rob Konrad
Aaron Elling | Dave Maurer | Brian Montesanto
Javier Vazquez
Benji Olson | Darrin Fletcher
Christian Broce | Ray Jackson | Bryant Young | Maurice Gordon
Quincy Yancy | Don Wengert
Josh Savage
Kevin Jackson | Tim Anderson
Gabe Kapler
Tyshaun Whitson | Ben Grieve
Abe Alvarez
Ross Verba
Kenard Lang | Kevin Foster | Pete LaForest
Ike Reese
Bo Hart | Demorrio Williams
Ashley Lelie | Ricky Williams | B.J. Lovett
Doug DeVore | Mike Mordecai
Rashied Davis | Ty Law
Damian Gregory | Justin Smith | Abraham Nunez | Jimmy Wyrick
Taylor Whitley
Jason Mathews
Matt Word | Wesley Phillips
Arnaz Battle | Chris Liwienski | Du'Shon Martin | Tebucky Jones | Mike Nakamura | John Parrish
Chris Angel | Sean Burroughs | Khary Campbell | Tyrone Rogers | Tom Wilson
Wilton Guerrero | Todd Pinkston
Justin McElfish
Damian Jackson | Roger Knight | Mark DeRosa
Rontrez Johnson
Mike Moriarty
ReShard Lee
Freddie Mitchell | Tyrell Godwin
Ben Hartsock | Dan Kolb
Teddy Lehman | Jeff Cirillo | Adam Wainwright
John Wasdin | Brandon Inge
Sam Adams | Bill Pulsipher | Mark Dalesandro
Jason Glenn | Mike Stanton | Az-Zahir Hakim | Bucky Jacobsen
Heath Murray | Randy Thomas | Ahman Green
Brett Jodie
Rob Turner | Tim Worrell | Nick Eason
Torry Holt | Kris Richard
Billy McMullen
Hines Ward
Brendan Harris | Paul Lacoste
Dan Plesac | A.J. Feeley
Leonard Weaver
Tom Nalen | Mike Karney
Randy Williams | Mike MacDougal | Dario Romero
Matt Diaz | Christian Fauria
Barrett Ruud | Mike Horacek | Terdell Sands | Brian N. Anderson
Bobby Higginson
Mark Lukasiewicz | Gabe Molina
Andra Davis | O.J. Atogwe
Todd Linden
Jerome Williams
Bryan Fletcher
Matthias Askew | Nate Robertson | Jimmy Miner | Anthony Herrera | Rodney Michael
Carmen Cali
B.J. Sander | Fred White
Rich Thompson | Kirk Morrison
Mark Wohlers
Jorge Cordova | Tanner Russell | Grant Roberts
Jose Canseco | Brandon Berger
Brian Banks | Raul Casanova | Eric Chavez | Heath Farwell
Orlando Hudson | John Browning | Nate Lawrie | Jimmy Haynes | Levron Williams | Johnnie Morant
John Stephens
Darnell Sanders | Danny Clark | Tony Parrish | Tom Goodwin | Claudio Vargas
Patrick Pass | Damian Rolls | Scott Tercero | Nathan Vasher | John Flaherty | Ethan Brooks
Dan Orlovsky | Darrell May | Tatum Bell
Joe Blanton | Siddeeq Shabazz
Devonte Edwards | Scott Sheldon | Greg Vaughn | Tony Terrell | Benji Gil
Courtney Anderson
Mike Edwards
Charles Woodson | Patrick Hape
Deion Sanders
Vic Darensbourg | Shane Andrews
Kelly Gregg | Roland Williams | Joe Burns
Frank Gore
Andy Barkett | Anthony Becht | Chuck James
Zach Duke | Karl Hankton
Dyke Van | Alfonso Pugh | Jeremi Johnson
Deion Branch | Ramon Ortiz | Ronald Flemons | Dustin Hermanson | Shea Hillenbrand
Prince Fielder
Floyd Womack
R-Kal Truluck
Alex Prieto | Ryan Burch | Carl Everett
Stephen Cheek | Hiram Bocachica
Kevin Barker | Jason Michaels
Jamal Jones | Mark Smith | Chad Fox
Rich Tylski
Obafemi Ayanbadejo
B.J. Sams
Ian Scott
Kevin Jordan
Brian Dawkins | Eric Westmoreland
Chris Horn | Roger Deago
Cedric Woodard | Willie Whitehead | Jamie Walker
Tom Gregorio | DeMarcus Faggins
Bryan Corey
Mike Green | Dan Miceli | John Bale
Jeff Fiorentino | Ramiro Mendoza | Larry Bigbie
Brian Jennings | Mark Tauscher
Paul Phillips | J.D. Durbin
Rich Scanlon
Andre Davis | Jeff Marriott
Ken Caminiti
Shaun O'Hara | Kyle Croskey | Nate Bump | Ben Graham
Tony Alvarez
Shane Halter | Dylan Gandy
J.R. Taylor | Oscar Villarreal | Scott MacRae
Greg Jerman | Isaac Sopoaga
Michael Powers | Craig Hentrich
Maurice Sonnier | Marcus Price | Dave Moretti
Kelly Dransfeldt | Rich Loiselle
Joe Nedney | Tracy White | Bobby McCray | Josh Scobey
Rashad Moore | Esteban Yan
Marcus Pollard | Jim Chamblee | Steve Hutchinson | Izzy Molina
Dennis Springer
Eric Munson | Luis Ayala
Andy Pettitte | Brian Kelly | Jay Witasick | Jerry Fontenot
Gerome Sapp | Justin McCareins | Kevin Walter | Ross Tucker | Chester Pitts | Chris Crocker
Russ Hochstein | Levi Madarieta
Kevin Orie | Scott Hairston | Bracy Walker
Ricky Manning Jr.
John Wehner | Kalani Sitake
Damane Duckett | Mike Morse | Eric Heitmann | Moises Alou | Kevin Jarvis
Danny Patterson | Wiki Gonzalez | Billy Volek | Brian Meadows
Shannon Stewart | Bryan Barker | Sean Considine | Scott Seabol
Ryan Thompson | Ron Wright
Andres Galarraga
Turk Wendell
Tomo Ohka
Rasheed Marshall
Cody Spencer | Kevin Johnson | David Bell
Felix Heredia | Stephen Smitherman
Erik Jensen | John Grabow | DaShon Polk
Tim Gale
Autmn  | Bill Conaty
Ron Edwards
Jeff Farnsworth | Rodney Peete | Jacob Bell
Brian Lawrence
Jayson Durocher
Darren Oliver
Tyler Johnson | Steve Green
Alex Stepanovich | Tom Martin
Reggie Wells
Vicente Padilla | Marques Sullivan
Rob Mackowiak | Scott Dohmann
Kevin Burnett | Cooper Carlisle
Jonathan Ordway | Gus Frerotte | Cullen Jenkins
J.R. Reed
Brendon Ayanbadejo | Niko Koutouvides
Trent Green | London Fletcher | Joe Crede
Marc Dunn | Marcus Bell | Dennys Reyes | Michael Hawthorne | Leon Johnson
Tony Richardson | Danny Graves | Tim Wakefield
Aaron Smith | Milo Lewis | C.J. Wilson | Mondre Dickerson
Mendy Lopez | Greg Norton | Ruben Mateo
Dante Hall | Jordan Black
Donnie Edwards | Kelly Holcomb
Rocky Calmus | Wali Rainer | Mack Strong
Adrian Dingle
Anthony Weaver | Corey Chavous | Kelly Campbell | Napoleon Harris
Robin Jennings | Mike Thurman
Brodney Pool | Jason Gilfillan
Matt Ginter | Andres Blanco | Joe Thurston | Jonas Jennings | Dave Elder | Marvel Smith
John Van Benschoten | Ron Smith | Marco Battaglia
Alvis Whitted
Robert Griffith | Stephen Spach | Sergio Mitre
Matt Wilhelm
Ryan Diepenbrock | Mike Gandy | Mike Williams
George Foster | Ryan Jorgensen
Jabar Gaffney | Bryant McKinnie | Kenderick Allen | Kawika Mitchell | Antonio Alfonseca | Marcus Reese
John Simon | Greg Myers | Juan Dominguez | Vinny Castilla
Raul Chavez | Gabe White | Doug Mirabelli
Rob Morris | Tony Romo
Khalid Abdullah | Jonathan Stinchcomb
Darryl Kile | Barry Sims
Darryl Hamilton
Matt Cepicky | Jerry Cowan | Keith O'Neil
Jeff Brunson | Roman Colon
DeShaun Foster | Chris Gray
Matthew LeCroy | Ben Zagorski | Bryan Johnson | Luis Martinez | Keyaron Fox
Shaun Marcum | Mason Unck | Andres Torres
Eric Ghiaciuc | John Franco
Elizardo Ramirez | Lee Suggs | Kyle Lohse | Ben Petrick
Aaron Miles
Bob Wells | Mark Budzinski
Pacman Jones | Mike Bacsik
Paul Lo Duca
James Taylor | Ike Hilliard | Eric Beverly
Tom Gorzelanny
Miguel Ojeda
Kenny Clark | Tike Redman
Frank Murphy | Moses Harper | Anthony Wright
Joe Lawrence | John Leake
Tony Blanco | Clarence Moore
Ryan Christenson | Joey Harrington | Todd Washington
Dave McCarty
James Harrison
Allan Simpson | Chris Denorfia
Jeff Liefer | Ryan Hoag | Mike Anderson | Hubert Thompson
Ben Diggins
Merkin Valdez | Jasen Isom | Terry Tiffee
Ryon Bingham
Jorge Campillo | Brian Tollberg | Josh Bullocks
Ed Reed | Clair St.
Alex Lewis | John Hall | Nelson Figueroa
Keith Osik | Phil Stambaugh
Kris Griffin | Cliff Johnson
Melvin Williams | Seneca Wallace | Mike Kinkade | Jim Sorgi
Rick Ankiel | Glendon Rusch | Nate Gates | Charles Rogers
Junior Glymph | Kyle Brady
Kenny Kelly
Jonah Bayliss | Travis Minor
Dorsett Davis | Mike Seidman
Bryce Fisher | Jason Roach | Ronnie Belliard | Kris Keller
Bret Saberhagen | Juan Sosa
Flozell Adams | Gabe Reid
Mike McKenzie | Jason David | Cam Cleeland | Steve McNair | Renaldo Wynn
Kris Jenkins
Luke Scott | Gibril Wilson | Franklin Nunez
Blue Adams | Phil Braxton
Charles Jones | Gavin Floyd | Brian Simmons | Jarret Johnson
Curtis Leskanic | Brian Lesher | Gennaro DiNapoli
Trot Nixon | Orlando Hernandez
Mike Lincoln | Jose Fuentes | Pat Mahomes
Bryant McFadden | Lawyer Milloy | Grey Ruegamer | Marcellus Rivers
Deuce McAllister | Angelo Crowell
Lamar Grant | Marty Malloy
Aaron Hill | Juan Moreno
Kevin Sefcik | Barry Gardner
Kirk Saarloos | Tom Ashworth | Nate Jackson | Rashaun Woods | Kenyatta Jones
Frank Brooks | Greg Maddux | Rob Davis
Will Cunnane
Bruce Nelson | Kenny Wright | Bret Prinz
Jason Phillips | Mark P. Johnson | Kailee Wong
Derrick Pope | Aaron Shea
Roman Phifer | David Wright
Miguel Tejada
Nnamdi Asomugha
Anthony Clement
Beau Fullerton
Fred Smoot
Mike Sellers | Torrie Cox | Dan Buenning | Shawn Camp | Ed Vosberg
Will Demps | Ted Lilly
Billy Wagner | Javon Walker
Tyoka Jackson | Cortez Hankton | Michael Woolridge | Chris Mohr | Adrian Brown | James Clyburn
Frisman Jackson | Fred Wakefield | Luke McCown
John Rocker | Lamont Burns
Marlus Mays | Antonio Hall | Ahmad Harris | Jay Bell
Brandon Jones
Pete Hunter | Jeno James
Paul Hoover | B.J. Symons
Langston Walker | Courtney Brown | Nick Leckey | Kelvin Kight | Chris Massey | Juan Diaz
Mike Peterson
Kris Foster | Takeo Spikes | Eric Edwards
Glenn Martinez | Darnell McDonald | Patrick Kerney
Chad Kreuter
Corey Jenkins | Grant Wistrom
Chris Douglas | Otis Leverette | Chad Hutchinson | Mike Timlin
Jay Johnson
Howie Clark
Tony Batista
Jimmy Journell
Ben Noll | Derrick Wimbush | Keyon Nash | Robinson Tejeda
Jason Kazar | Chris Prieto | Bobby Hamilton
Rico Brogna
Rickey Henderson | Mario Encarnacion
Toby Gowin | Dan Johnson | Jerome Mathis | John Turntine | Quentus Cumby
Enoch DeMar
Derrick Burgess | Shaun King | Ron Ockimey | Jason Giambi
Wayne Gandy
Terry Adams
Clarence Williams | Chris Dishman
Joey Harris | Michael Restovich | Ryan Rupe
Christian Parker | Morgan Burkhart | Brandon Claussen
Todd Heap | Jeff Austin | Shane Costa
Kenneth Hilliard | Jason Bulger
Andy McCollum | Joe Randa | D.J. Houlton | Scott Rolen
Marcus Johnson | Eric Green | John Valentin | Danys Baez
Jacques Cesaire | Carlton Loewer
J.J. Arrington | Brian Kozlowski
Chris Tremie
Nathan Hodel | Mike Gonzalez
Shane Nance | Cameron Spikes
Jaret Wright
Horacio Estrada | Brian Fuentes
Aaron Holbert | Micah Knorr
Jared Sandberg | Leo Estrella
Enrique Wilson | Joe Vitiello | Tony Brown | Antonio Perkins | Jed Weaver
F.P. Santangelo
Fred Booker | Robert Perez | Cory Withrow
Bobby Munoz | Earl Snyder | Cedric Killings | Guss Scott
Wade Richey | Derrick Ransom | Bret Boone
Cliff Politte | Dave Martinez | David Wells | Michael Rivera
Scott Kooistra
Jason Beverlin | Artie Ulmer | Chris Magruder | Casey Rabach | Lee Stevens | Bill Selby
Don Muhlbach | Pete Orr | Aaron Boone | Kris Benson
Paul Bako | Kwamie Lassiter
Eduardo Perez
Braden Looper
Anthony Lerew
Phillip Buchanon | Todd Sauerbrun
Mike Hubbard | Cameron Cleeland | Deontey Kenner
Randall Gay | Jamal Strong | Felix Hernandez
Cory Sargent
Keiwan Ratliff | Alshermond Singleton
David Segui
Joe Andruzzi | Lorenzo Diamond | Rick Short | Damon Minor
Chris Demaria
Felix Escalona | Russell Branyan
Ryan Raburn | Chris Hoke
Robin Ventura | Drew Brees
Stan Javier | Earl Little
Steve Perretta | Todd Coffey
Vince Manuwai | Charles Lee
Patrick Mannelly | Brad Thompson
Chris Oliver | Julio Manon | Jung Keun Bong | Bartolome Fortunato | Nate Kaeding
Mike Johnson
Terrell Roberts | Joe Saunders
Ben Weber | Marcus Wilkins | Asante Samuel
Adrian Madise | Bart Miadich
Brett Beard | Josh Ranek | Joe Mauer
Darren Holmes | Jack Wilson | Hideo Nomo
Wandy Rodriguez | Val Majewski | Justin Miller
Ben Archibald | Chad Stanley | Aaron Fultz
Lance Schulters
Mike Rumph
Ronald Hardge | Jeff Zgonina | Raynoch Thompson | B.J. Upton
Jay Bellamy | Lewis Moore | Ervin Santana
Brady Smith | J.R. Redmond
Devon White | Carlos Zambrano
Ron Gant | Dennard Wilson | Elliot Silvers
David Patten | Monty Montgomery | Steve Sciullo | Donovan Osborne
Thomas Jones
LaDainian Tomlinson
J.T. Snow | Derrek Lee
Darrell Hill | Willie Williams
R.A. Dickey | Edell Shepherd | Dan Neil
Mario Edwards | Tripp Cromer | Charlton Jimerson | Karlos Dansby | Thomas Houchin
Santana Moss | Tim Drew
Lance Carter
Matt Kranchick | Jeff Hartings
Jeremy Hill
Nick Rogers | Mike McMahon | Darrion Scott
Joe Davenport
Joe Girardi | Scott Mullen | Bobby Engram
Josh Wilson | Dean Palmer | Alex Cintron
Barrett Green | Robert Royal | Jamie Duncan
Corey Bradford | Buddy Groom
Khiawatha Downey | David Tyree | Juan Encarnacion | Peerless Price
Dave Puloka
Hunter Smith | Carlos Guillen
Keith Traylor | Jamarei Bryant
J.T. Thatcher | Aaron Small
Triandos Luke | Bobby Gray | Jerome Davis
Miguel Perez | Joey Porter | Chike Okeafor
Chris Simms | Mark Little | Jason Jennings | Ben Howard
John Stone | Carlos Baerga
Jamal Williams
Jeff Francoeur | Allen Levrault
Joaquin Gonzalez
Jay Riemersma
Gary Sheffield
Eddie Canonico | Barrett Brooks
Tony McKnight
Lance Painter | Randall Simon
Dennis Northcutt
Orlando Brown | P.J. Fleck
Rashad Bauman
Andy Benes
Barry Bonds | Delvin James
Brandon Barnes
Ken Irvin | Fernando Tatis
Matt Roney | Rodney Bailey | Gary Walker | Brandon Jacobs
Jason Baggett | Anquan Boldin
Eddie Moore | Ben Johnson
Kevin Joseph | Michael Cuddyer | Angel Pena
Ruben Gotay | Stuart Schweigert
Mike Lansing | Chris Baker | Jason Dubois
Keith Heinrich | Jermaine Dye
T.J. Tucker
Travis Blackley | Alexis Gomez | Teddy Johnson
Chris Duffy | Tony Mounce | Dre' Bly
Justin Atchley | Troy Walters | Fernando Cabrera
Rod Davis | Torrin Tucker
Omare Lowe | Tony Pashos
Richard Hidalgo | Frank Catalanotto | Mike Hawkins
James Mouton | Calvin Pickering
Dave Burba | Junior Siavii | Matt Stinchcomb
Scott Dunn | Mike Buddie
Kyle Davies | Doug Brocail | Zach Day
Robb Nen | Alex Brown
Kevin Lewis | Steve Watkins
Dewayne Robertson | Keydrick Vincent | Pedro Santana | Brad Wilkerson
Michael Myers
Joe Beimel | Calvin Murray | Keith Brooking
Matt O'Dwyer | John Denney | Eugene Wilson | Willie Blade
Travis Hafner
Orlando Huff | Nate Field
Jonathan Quinn | Jeremy Caudill | Adam Eaton | Jason Baker
Nate Cornejo | Jose Castillo | Corey Dillon | Giovanni Carrara | George Wilson | Derrick Ward
Keiichi Yabu
Gary Knotts | Robert Fick | Chris Johnson | Chris Resop
Oliver Perez | Terrmel Sledge | Jeremy LeSueur
D.J. Carrasco | Hugh Douglas
Oscar Henriquez
Adam Shabala | Brad Eldred
Nick Barnett | Alex Rodriguez
Damaso Marte | Shaunard Harts | Kris Dielman
Kenny Peterson
Gil Heredia | Josh Beckett
Simon Pond | Sam Narron | Jorge Julio | Dexter Jackson
Bo Scaife
Sammy Morris
Michael Nattiel
Ty Detmer
Pedro Cirino | Bill Hall
Ramon Walker | Pete Zoccolillo
Lacorey Street | Randy Bell
Khary Jackson | Jay Powell
Darrell Jackson | Donte Curry
Dave Williams
Arlen Harris
Brian Anderson | Jamaal Green | Rob Bironas
Greg Jones | Jason Johnson
Kerry Carter | Phil Smith | Darnerien McCants | Carlos Delgado
Daniel Graham | Shingo Takatsu | Byron Parker
Chris Richard | Aaron Gibson | Jerry Montgomery | Josh Hall
Perry Carter
Richard Angulo | Brian Finneran
Keith Foulke | Levi Jones
Mike Caruso
Terrence Kiel
Jeromy Burnitz
Shane Spencer
Javier Valentin
Rashean Mathis
Chris Kluwe | Mike Doss | Brad Lidge | Chin-hui Tsao | Kevin Bentley
Andy Abad
Alejandro Freire | Anthony Adams | Antonio Cochran
Drew Bledsoe | Dan Serafini
Justin Ena
Chuck Knoblauch
Liam Ezekiel | Eduardo Villacis | Josh Kroeger | Jim Leonhard
Troy Brohawn | Steven Cain | Joe Strong
Michael Koenen | Brian Tallet | Jason Tyner | Cesar Izturis | Andruw Jones
Warren Sapp | Colby Bockwoldt
Graham Koonce | Jimmy Blanchard | Pete Munro
Adam Seward | Carlos Hall
Kevin McCadam | Juan Rivera | Gus Jacobs | Kenny Heatly | Andrew Sisco
Tyrone Carter | Reggie Tongue | Qasim Mitchell | Melvin Mora
Lionel Barnes | Kelvim Escobar
Anthony Floyd | Curtis Martin | Neil Rackers | Scott Wells | Jose Bautista
Mark Bradley | Vernon Fox | Tyrone Calico | Omari Jordan | Edgardo Alfonzo
Danny Ardoin
Deltha O'Neal | Mike Abrams
Kevin Correia | Craig Monroe
Derrick Knight | Alfonso Marshall
Byron Gettis
Rian Lindell
Matt Murphy
Jimmy Farris | Eric Parker
Josh Brown | Bart Scott | Tory James
Ambiorix Burgos | Tyrone Robertson | Willy Taveras
Mike Myers | Ryan Vogelsong | A.J. Burnett
Dennis Cook | Pierre St. | Reggie Torbor | Nate Clements
Ty Myers | Tim Christman | Donnie Nickey
Ben Hendrickson | Shigetoshi Hasegawa
Geovany Soto
Jason Simmons
Dan Koppen | Justin Knoedler | Luke Allen
Duke Preston
Scott Proctor
Jason Marquis | Wayne Franklin
Sean Burnett | Steve Torrealba | Josh Bidwell | John Patterson
Jake Grove | Amon Gordon | Kareem Ellis | Duane Clemons
Henry Blanco
Ed Jasper
Terrance Metcalf
Jake Delhomme | Yeremiah Bell | Daniel Cabrera | Roberto Novoa | Marvin Harrison | Mike Fontenot
Matt Franco | Victor Martinez
Reggie Myles | Mark Gardner
Matt Riley
Steve Colyer | Todd Fry
Ray King | Eric Johnson
Jesse Ohliger
Shaud Williams | Lorenzo Barcelo | Jeff Shoate
Wilson Valdez | Duke Pettijohn
Cedric Cobbs | E.J. Henderson | Chad Moeller
Cody Ransom
Billy McMillon | Milton Bradley | Alejandro Machado | Andre Reed
Bennie Joppru | Nick Harris | Rene Rivera
Kavika Pittman | Curtis Whitley | Corey Hart
Aeneas Williams | Tony Armas | Eddie Guardado
Chris Spencer
Matt Murton
Luis Garcia
Bryan Robinson
John Duckett | Wes Obermueller
Josh Stamer | Demetric Evans | Kris Mangum | Barry Wesson
Rudy Seanez | Karon Riley
Eric Knott | Patrick Ramsey
Luther Hackman | Michael Boulware | Bob Scanlan
Jaime Bubela | Gary Bennett
Clint Kriewaldt | Dustin Colquitt | Mark Ellis | Shawn Estes | John Abraham
Derrick Deese
Gary Matthews Jr. | Alfredo Amezaga
Larry Barnes | D'Angelo Jimenez | Kelley Washington | Steve Stemle
Boo Williams
Rickie Weeks | Jon Condo | Courtney Duncan
Todd Yoder | Eric Young | Antrel Rolle
Carlos Valderrama | Luis Pineda
Donnie Sadler
Rushen Jones | Kazuhisa Ishii | Craig Hansen
Neifi Perez | Ben Roethlisberger
Gene Stechschulte | Livan Hernandez
Hank Poteat | Jared Fernandez
J.J. Moses | Garrett Stephenson | Todd Walker
Michael Young | Brett Pierce
Fakhir Brown
Randy McMichael
Irfanud din | Wayne Gomes | Seth McKinney | P.J. Mays | Jae Seo | Brooks Kieschnick | Monty Beisel
Cliff Bartosh | Terry Shumpert | Jeff Womble
Fred Miller
Carlos Rogers | Todd France | Courtney Watson
Justin Smiley
Mike Colangelo | Joel Peralta
Carlos Polk | Ramon Martinez | Terrence Metcalf
Carlos Rivera | Zamir Cobb
Todd Hollandsworth | Donnie Murphy | Luke Petitgout | Mike Wahle
Seth Payne
Marcos Carvajal | Travis Hughes
Craig Grebeck
Zach Piller
Scott Munter | Seth Etherton
Joel Pineiro | Rich Gardner | Jeff Weaver | Josh Willingham
Terry Glenn | Dustin Lyman | Travis Brown
Brandon Webb | John Gilmore | Leslie Brea | Adam Bergen | Ryan Pickett
Fred Jones
Kerry Collins | Ben Troupe
Bobby Wade | Nicholas Harper | Andy Fox
Robaire Smith
Brett Tomko
Greg Comella
Arthur Rhodes
Ron Calloway
Cory Hall
Donovan McNabb
Frank Chamberlin
Steve Morley | Will Heller
Chad Bentz | T.J. Duckett
Kendrell Bell | Anthony Thomas | Kevin Millar | Randy Wolf | J.P. Losman | Ryan Kuehl
Joe Oliver | Ryan Church
Steven Jackson
Terrance Chapman | Jose Paniagua
Kevin Appier | James Lee | Randall Cummins | Doug Jolley | Nick Novak
Daleroy Stewart | Marco Coleman | Eddie Berlin
Sione Pouha | Jamall Broussard
Fred Taylor | Mike Scifres | Michael Jameson | John-Ford Griffin
Dan Wilson | Raul Gonzalez | Scott Brosius
Scottie Vines
Marquand Manuel
Juan Alvarez | Sam Aiken | Bryan Pittman
Curome Cox
Chad Lewis
Dustin McGowan | Bronson Arroyo | Bobbie Williams | Jerome Woods
Leander Jordan | Quincy Morgan | Jaime Cerda | Al Reyes | Guillermo Quiroz
Brandon Miree | Chad Morton
Tomas Perez | Raymond Taupule
Brandon Noble
Ricklan Holmes-Miller | Julius Matos
Dewayne Wise | Adam Greenberg | Andy Ashby | Randy Knorr
Pedro Swann | Josh McCown | Jeff Mitchell
Jeremy Bonderman | Quincy Carter
Chris Hanson
Tutan Reyes | Ian Allen
Franklyn German | Sly Johnson | Matt Chatham
Edwin Mulitalo | Robert Thomas
Ray Olmedo
Roberto Hernandez | Carlos Emmons | Rodney Myers
Bill Ortega | Cedric Houston | Antowain Smith
Rich Coady
Julian Battle
Troy Williamson | Adam Vinatieri
Joe Horgan | Chin-Feng Chen
Les Walrond
Cato June
Bryant Johnson | Corey Sears | Brayan Pena | Brian Griese | Brandon Chillar | Brandon Lloyd | Manny Delcarmen
Jeff DaVanon | Paul Shuey
Kevin Walker | Kevin Witt | Eric Brackins | Chuck Smith | Rocky Coppinger
Mark Loretta | Brandon Kolb
Mike Judd | Jason Kubel | Derek Rackley
Drew Haddad | Jose Rodriguez | Gary Anderson
Ricot Joseph
Jason Hanson | Ken Amato
Antwoine Womack
Bernie Castro
C.C. Brown | Tyler Walker | Andy Payne
Tony Bryant | Garret Anderson | Mike Kraemer
Bob Dzvonick | David Loverne | Marcus Fields | Brook Fordyce
Armando Reynoso | Dorsey Levens
Derrick Fletcher | Wendell Magee
Shockmain Davis | Kelly Wunsch
Alan Ricard | Joey Gathright
Cody McKay | Kevin Beirne
Danny Garcia | Doug Nickle | Ron Mahay | Julio Zuleta
Ben Leber | Mewelde Moore
Keith Lewis | Corey Ivy | Doug Mientkiewicz
Marcus Coleman
Garrison Hearst | Jim Miller
Corey Simon | Francisco Santos
Donnie Spragan
Jack Brewer
Kevin Jones
Adrian Beltre | Jordan Babineaux | Ricky Ledee
Jon Lieber
Dustin Nippert
Kevin Watson | Mike Lowell | Juan Cruz | Sean Morey
Mike Jackson | Morgan Ensberg | Fernando Seguignol | Kazuo Matsui
Ryan Freel
Eric Crozier
Rex Tucker
Josh Evans | Josh Scobee
Pat Rapp | Evan Routzahn
Mike Koplove | Robert Branch
Taylor Jacobs | Rob Petitti
Arfan Jafar | Kendall Newson | Will Beck | Brian Jordan
Miguel Cairo
Ryan Moats | Lee Gardner
Andrew LeClair
Larry Casher | Rey Sanchez | Jay Bergmann | Jerrod Riggan
Morten Andersen
Akinori Otsuka | Nick Neugebauer
Omar Stoutmire | Cornelius Griffin
Keith Davis | Mario Valdez | Jimmy Kennedy
Mark Brunell | Billy Koch | Ethan Howell | Duce Staley
Kim Herring
Jerame Tuman
R.Jay Soward | Zach Wiegert
Hector Carrasco | Dominic Raiola | Al Wallace | Paxton Crawford
Hansel Izquierdo | Luis Figueroa | Jason Young | Ricky Manning
Ray Mickens | Shaun McDonald | Randy Flores
Eric Bruntlett | Ken Dilger
Kameron Loe | Lee Mays
Mark Campbell | Jay Hackett
Scott Elarton | John Anderson | Ben Kozlowski | Ivan Cruz
Thomas Davis | Matt Kata | Clay Condrey | Cory Vance
Jose Cabrera | Bernard Gilkey | Robert Malone
Reuben Droughns | Corey Smith
Ted Washington | Chad Pennington | Tony Stewart | Darren Sharper | Yhency Brazoban | Andrew Pinnock
Jolbert Cabrera | Jose Offerman
Hipolito Pichardo
Matt Ball | Tim Byrdak | Ross Kolodziej
Michael Pittman | Reynaldo Garcia | Alonzo Shuler | Akbar Gbaja-Biamila
Rob Ryan | Neal Cotts | Bryan Jones
Jeff Bajenaru | Rod Frazier
Lance Legree | Jack Cust | Carlos Febles
Ladell Betts
Sean Henn | Chone Figgins
Paul Konerko | Ryan Howard
Derrick Blaylock | Tony Torcato | Ryan Ludwick
Steve Heiden | Donaldo Mendez
Trey Darilek
Aaron Looper | William Joseph | Jason Anderson
Brian Johnson
Randy Winn | Fernando Rodney
Alonzo Ephraim | Rod Beck
Frank Thomas
Pedro Feliz
Kenan Blackmon | John St. Clair
Alan Reuber
Chris Davis | Greg Schindler | Tom Davey
Kassim Osgood | Robbie Tobeck | Todd Stottlemyre | Antonio Gates
Clay Bellinger | Sam Madison
David Moreno | Yorman Bazardo | Walter Sampson | Kory Chapman
Matt Whiteside | Sedrick Hodge | Devery Henderson
Fernando Lunar | Michael Bennett | Alphonso Roundtree
Jon Runyan | Jeb Putzier | Phil Hiatt
John Thornton | Joe Nelson
Jeremy Fikac
James Whitley | John McDonald
Charles Grant | Odell Thurman | Elmer Dessens
William Bergolla | Brady Raggio | Zeron Flemister
Sidney Ponson | Scott Podsednik
Adrian Klemm | Chad Mustard | Nate Webster
Cliff Brumbaugh | Freddy Sanchez | Brian Howard | Jimmy Kleinsasser
Erron Kinney
Hector Mercado
Jason Davis | Ricardo Rincon
Izell Reese | Christian Morton | Mike Gallo
Richie Anderson | Courtney Roby | Isaac Bruce | Roger Clemens
Bosch Vanden | Wily Mo Pena | Travis Taylor
Kevin Kasper | Wascar Serrano | Kiko Calero
Jason Repko
Tully Banta-Cain | Alex Ardley | John Carney
Gary Johnson | Michael Waddell | Dennis Weathersby | Derek Ross | Chad Gaudin | Eddie Oropesa
Albie Lopez
Reggie Newhouse | Jose Acevedo | Jesse Chatman | Tony Weaver | Jonathan Beasley | Dante Bichette
Corey Williams | Jonathan Vilma | Chris Donnels
Pat Strange | Howard Green | Jimmy Williams
Ricky Proehl | Dave Bush
Mike Mussina
Travian Smith | Adrian Jones | Mike Porzio | Chad Meyers | Darren Woodson
Kellen Winslow | Danny Kanell | Trevor Johnson | Scott McGarrahan | James Jackson
Mike Vrabel | Tyronne Armstrong | Freddy Guzman
Eric McCready
Sebastian [1903]Oakland Raiders Janikowski
Carlos Francis
Rohan Davey | Justin Thompson
Ken Dorsey | Roy Halladay | Jose Cruz Jr.
Jody Gerut
Bryan Scott | Tom Nutten | Wilson Alvarez
Noel Ellis | Tim Carter | Masao Kida | Ryan Lilja | Antuian Bradford
Justin Speier | Leonardo Carson
James Sanders
Robinson Cano
Todd Ritchie
Brad Hennessey | Doug Glanville
Jerry Porter | Dave Zastudil | Ryan Fowler
Edgar Martinez
Rafael Furcal
Ricky Stone | David Dixon | Preston Wilson | Royce Clayton
Jason Horton | Jeremiah Garrison | Demario Suggs | John Engelberger | Russ Johnson | Earl Holmes
Mark Brown | Julian Peterson | Felix Sanchez
Brad Badger | Scott Player | Renaldo Hill
David McMillan | Tom Brady
Midre Cummings | Yamid Haad | Jose Macias
Ryan Nece | Dee Brown | Byung-Hyun Kim
Troy O'Leary | Cha Seung Baek
Bill Spiers | Charles Thomas | Adam Peterson | Randall Godfrey
Steve Woodard | Ethan Kelley
Todd Fordham | Langston Moore
Doug Henry
Marques Tuiasosopo
Chad Brown | Tim Salmon | John Frascatore | Roger Cedeno | Mike Curry
James Dearth
Lawrence Smith | Victor Alvarez | Kevin Tapani | Shelton Quarles | Matt Joyce | Chris Seelbach
Craig Page | Ryan Garko
Terry Mulholland
Billy Miller
Doug Brzezinski
Mark Gould | George Sherrill | Jason Fabini
Johnathan Sullivan | Justin Wayne | Brian Daubach | Dave Coggin | Ben Nauman | Geraldo Guzman | Kelly Herndon
Tony Fiore
Graeme Lloyd | Steve Trachsel | Mike Maslowski | Mike Rosenthal
Clenton Ballard | Mark Leiter | Juan Cerros | Kevin Worthy | Chad Tracy
Joey Hamilton | Alvin McKinley
Jameel Cook | Hakeem Kashama
Kevin Ohme | Roderick Green
Mac Suzuki
Jim Crowell
Paul Abbott | Henry Rodriguez
John Buck
Adrian Peterson | Bennie Alexander | Jeff Backus
Ray Lewis | Mark Guthrie
Tyrone Williams
Jamar Martin | Miguel Asencio
Trevor Hoffman | Nate Bandy | Steve Karsay | Lawrence Turner
Napoleon Calzado | Terrance Shaw
Jonathan Broxton | Antoine Winfield
Jeremy Reed | Mike Gulan | Derrick Johnson | Brandon Watson
Jevon Kearse | Antonio Chatman | Rick Bauer
Shaun Cody | Mario Ramos
Al Wilson | Tony Gonzalez
Nelson Cruz
Trevor Pryce
Lenny Walls | David Thornton
Stephen Trejo | Dave Pember | Noah Lowry | Craig Wilson | Luke Hudson
Jonathan Ogden | Chris Pittman
Garrett Atkins | Andrae Thurman
Carlos Pulido | Arnie Munoz
Raylee Johnson
Erasmus James
Chris Perry | Patrick Surtain
Joe Tafoya | Chan Ho Park | Kyle Snyder | Monreko Crittendon | Josh Hancock
Jimmy Gobble | Jose Cortez | Seth Wand | David Richardson
Steve Neal | Michael Roos | Todd Peterson
Matt Erickson | Rene Reyes
David Terrell | Daniel Wilcox | Eddie Perez
Vinny Ciurciu | Homer Bush | B.J. Surhoff
Terry Jackson
Stacy Andrews | Tommy Hendricks | Russell Davis
Jake Plummer | Jose Flores | Rigo Beltran | Dontarrious Thomas | Nick Swisher | Jamie Brown
Stephen Randolph | Jon Dorenbos | Sean McNicholas | Bryan Gilmore
Ken Huckaby | Scott Winchester
Ramon A. Castro | Amos Zereoue
Toniu Fonoti | Sam Brandon
Larry Johnson | Makai Freitas | Kyle Farnsworth | Lional Dalton
B.J. Johnson | Steve Bush
James Jordan
Wade Miller
Gerald Williams | Roy Corcoran | Chris Cooley
Jason C. Phillips | Erik Sabel | Alex Sanchez
Rich Rodriguez | Brady Clark | Adam Johnson | Eddie George | Corey Patterson
Ran Carthon
Brian Bohanon | David Sanders | Will Allen
Jeff Abbott
Jeff Feagles | Brad Pyatt | Doug Flutie | Michael Walker | Jose Ortiz
De'Wayne Hogan
Brandon Phillips | Jason Bartlett
Ahmed Plummer | Chris Peters
Kerry Ligtenberg | Brian Shackelford
Jared Allen | Mike Duvall | Marcus Robinson
Aaron Dalan | Francis Beltran | Mike Mahoney
John Maine | Jose Morban
Tony Gwynn | Andy Pratt | Brent Abernathy
Coco Crisp | Steve Foley
Tim Bowens
Bradie James | Mario Haggan | Ed Rogers | Alan Mills
Aaron Glenn
Mike Bartrum | Jason Ellison
Chuck Finley | Orber Moreno
Larry Foote
Mark Simoneau | Matt Treanor
Josh Phelps | Elton Patterson
Mike Darr
Ryan Theriot | Rudi Johnson | Matt Mauck
Rob Murphy | Adriano Belli | Jesse Crain
Josh Stewart | Fabian Washington
Michael Barnett | Chris Carpenter | Travis Driskill
Charles Gipson
Jason Peters | Jim Kleinsasser | Nathan Jones | Odalis Perez
Chad Scott | Simeon Rice
Troy Fleming
Olin Kreutz | Jerry Wunsch | Felix Jose | Al Levine
Andre Gurode | Marques Douglas
Igor Olshansky
Dave Matranga | Chris Samuels
Ed Sprague | Steve Smyth
Luther Elliss
Victor Hobson | Scott McClain
Ed Wilder | Martin Bibla | Bo Porter
Will Poole | Ty Wigginton
Adalius Thomas | Chidi Ahanotu | James Hall
Heath Bell | Morlon Greenwood
Marc Boerigter | Olmedo Saenz
Shedrick Copeland
Chase Blackburn
Erik Bedard | Mario Fatafehi
Josh Fogg
Dewayne White | David Lundquist | Dan Klecko | Chad Curtis | Todd Johnson
Mike Piazza | Vince Wilfork
Matt Bryant | C.C. Sabathia
Quintin Mikell | Brian Moorman
Rashad Baker | Madison Hedgecock
Andre Frazier
Torii Hunter | Brett Hinchliffe | Derek Watson | Travis Fisher | Chase Utley
Antuan Edwards | Ben Davis | Larry Turner
Robert Ferguson
Dave Petruziello
Roydell Williams | Alan Harper
Zach Sorensen
Tony Clark
Chad Eaton
Damon Buford | Juan Acevedo
Terrence Long | Adrian Gonzalez
Shawn Bryson
Chris Gamble | Deke Cooper
Matt DeWitt
Kevin Thomas | Terry Fair
Ron Stone | Matt Blank
Dana Eveland
Jonathan Johnson | Jon Ritchie
Brian Allen
Jamie Winborn | Brock Forsey
Steve Herndon | Jermaine Lewis | Lewis Powell | Mark Clayton | Chris Terry
Terry Pierce | Mike Smith | Kevin Cash | Cornell Menafee
Jeff Saturday | Esteban German
Jim Mann
Alex Gonzalez | Eric Davis | Matt Lepsis
David Ortiz | Karl Paymah
Kevin Williams
Bryan Bullington | Dernell Stenson
Ernest Wilford | Todd Dunwoody | Luis Terrero
Manny Aybar | Trent Cole
Mike DiFelice | Jason Maxwell
Dennis O'Sullivan | Tra Thomas | William Bartee
Mike Schneck | Jason Bay | Nick Ferguson
Aaron Thompson
Chris Mears | Jon Kitna
Esteban Loaiza | Todd Sears | Luis de los Santos
Brock Marion
Tywoin Breaux | Scott Wiggins | Jay Williams
David Manning
Chris Clemons | Kevin Youngblood | Anderson Machado
Ian Snell | Brian Young | Jesse Foppert | John Webb | El Randle
Jim Rushford | Jason Whittle | Kent Mercker | DeMarcus Ware
Brandon Casavan | Armando Almanza | Javier Lopez
Ron Villone | Derrick Walker
Khari Long | Scott Baker | Marshall Faulk | Ken Griffey Jr.
Travis Hall | Jeff Branson | Ryan Bachman
Mike Furrey
Larry Fitzgerald | Vinnie Chulk | Andy Hogan
Jason Jones | Sam Rayburn
Hunter Hillenmeyer | Derrick Frost
Horacio Ramirez
Luis A. Gonzalez | Omar Daal
Donovan Morgan | Yorvit Torrealba | Lawrence Tynes
Ryan Bukvich | Otis Amey | Royce Ring | Matt Stewart
Cody Pickett | Zeke Moreno | Bob Sanders
Alan Faneca | Brooks Bollinger | Marvin Jackson | Mark Bruener | Fred McCrary
Felix Martinez | So Taguchi
Chris Hammond
Reynaldo Hill | Bryan Thomas | Leonard Henry | Kevin Olsen
George Lombard
Allen McDill | Roberto Alomar | Jeff Ruffin | Scott Hatteberg
Chris Burke
Marcus Spears | Scott Gragg
Kimo von Oelhoffen | Fred Weary
Jack Taschner | Terry Johnson
Edwin Jackson | Ralph Brown
Anthony Reyes | Victor Santos | Robert Ellis
Tyler Yates | Drew Bennett | Kevin Youkilis | Brandon Short
Chidi Iwuoma | Eric Ogbogu
Keon Moore | Hanley Ramirez
Cornell Green
David Pollack | Mike Patterson | Lauvale Sape
Andy Aracri | Norihiro Nakamura
Brennan Curtin
Will Peterson | Todd Belitz
Eddy Rodriguez | Jorge Sosa | David Bowens
George Wrighster | Matt Martin
Jason Elam | Justin Morneau
Mike Hessman
Kenny Mixon | Rich Hill | Mandy Romero
Joe DePastino
Jason Nikolao | Jason Pearson | Claude Terrell
Eric Gagne | Brian Myrow
L.J. Shelton
Reggie Howard | Dwight Smith
Harold Morrow | Chris Harris
Dave Borkowski
Grady Sizemore | Travis Smith | Chris Brock
Joe Zelenka | Daimon Shelton | Jonathan Carter
Chad Williams | Ryan Tucker | Aaron Francisco | Dallas Clark | Vernand Morency | Gabe Crecion
Jon Skinner
Patrick Chukwurah | Adam Melhuse | Octavio Dotel | Caleb Miller | Samari Rolle
Brandon Green | Robert Person
Darren Bennett | Hayden Penn | Tim Rattay | Marty McLeary | Anthony Mitchell | Marvin Benard | Brad Fullmer
Matt Anderson | Jason Hart | Robert Sanford
Marlon Anderson | Kevin Pickford
Ed Dangerfield
Logan Mankins
Rien Long
Tank Johnson
Tommy Maddox
Matt Lehr | Brian Mallette
Kris Wilson | Javy Lopez
Darren Howard | Rich Seubert
Charles Tillman | Roderick Bryant
Jared Lorenzen
Visanthe Shiancoe | Pete Kendall
John Turman | Todd Weiner | John Koronka
Joey Eischen | Sunny Kim | Eric King
Rich Gannon | Jeff Shaw | Nick Sorensen | Mike Flynn | Adam Pettyjohn
Ben Taylor | Ron Dayne | Todd Hundley
Sam McConnell | Jorge de la Rosa | Cliff Russell
Jonathan Papelbon
Terrence Melton | Kevin Nagle
Roderick Hood | McKay Christensen
Chad Beasley | Jay Buhner
Al Singleton
Jason Jimenez | Karim Garcia
Darryl Blackstock
Laroni Gallishaw | Tyson Thompson
Tom Tupa | Greg Aquino
Reggie Wayne
Jorge Cantu | Charlie Anderson | Dhani Jones | Peter Boulware | Nick Bierbrodt | Hank Fraley
C.J. Mosley
David Rackley
==================== Display buckets with max. number of collisions ====================
Hash value | 328
Keys       | Bobby Kielty | Spencer Johnson | Major Applewhite | Grant Irons | Paul Quantrill | Robert Taylor | Jason McKie | Jeremi Gonzalez
